-18
17
-11
9
111111111111111111111111111111111111
100000000000000000000000000000000001
100000000000000000000000000000000001
100000001001000000000000000000000001
100000000001000000000000000000000001
100001100000000000000000000000000001
100000000000000000000000000000000001
100000000000000000000000010000000001
100000001110000000000000010000000001
100000001110000000000000010000000001
100000000000000000000000010000000001
100000000000000000000000010000000001
100000000000000000000111000000000001
100000000000000000000000000000000001
100000000001100000000000000000000001
100000000001100000000000000000000001
100000000001100000000000000000000001
100000000001100000000000000000000001
100000000000000000000000000000000001
100000000000000000000000000000000001
111111111111111111111111111111111111
