0000000000111000110000011001111110111110111111111111100001111110011001111111110000111111111111
0000000000000000000001110111111111111001111111111100001000000001111000111010000011001100000101
0000000000111100111011111111100110001111111100000000011110000001111001111011001110000000100000
0000000000111010000011111110011001110100000000010000000000011111101111111010111110001111111111
0000000000001100000000000000000000000000000000000000000000000000000000000000000000000000011101
0000000000111110000000000000000000000000000000000000000000000000000000000000000000000000000000
0000000000111110000000000000000000000000000000000000000000000000000000000000000000000000001111
0000000000100000000000000000000000000000000000000000000000000000000000000000000000000000010000
0000000000000010000000000000011110000000000000000000001000000000000001100000000000000000011111
0000000000100000001000000000000000000000000000000000000000000000000000000001000000000000011111
0000000000111100001000000000000000000000000000000000000000000000000000000000000000000000011111
0000000000111100000000000000000000000000000000000000000000000000000000000000000000000000011100
0000000000001110000000000000000000000000000000000000000000000000000000000000000000000000011111
0000000000111100000000000000000000000000000000000000000000000000000000000000000000000010011100
0000000000111110000000000000000000000000000000000000000000000000000000000000000000000010010000
0000000000111100000000000000000000000000000000000000000000000000000000000000000000000000000000
0000000000111110000000000000000000000000000000000000000000000000000000000000000000000000000000
0000000000001110000000000000000000000000000000000000000000000000000000000000000000000000000111
0000000000011110000000000000000000000000000000000000000000000000000000000000000000000000010100
0000000000100000001000000000000000000000000000000000000000000000000000000000000000000000000001
0000000000111110000000000000000000000000000000000000000000000000000000000000000000000000000111
0000000000011110000000000000000000000000000000000000000000000000000000000000000000000000011111
0000000000100100001000000000000000000000000000000000000000000000000000000000000000000000011100
0000000000000010000000000000000000000000000000000000000000000000000000000000000000000100011100
0000000000101110000100000000000000000000000000000000000000000000000000000000000000000000000000
0000000000110100000000000000000000000000000000000000000000000000000000000000000000000000000011
0000000000000000000100000000000000000000000000000000000000000000000000000000000000000000001000
0000000000110010001100000000000000000000000000000000000000000000000000000000000000000000010111
0000000000000110001000000000000000000000000000000000000000000000000000000000000000000000011011
0000000000001110000000000000000000000000000000000000000000000000000000000000000000000100011111
0000000000110010000000000000000000000000000000000000000000000000000000000000000000000010000001
0000000000000000000000000000000000000000000000000000000000000000000000000000000000000000011111
0000000000100010000100000000000000000000000000000000000000000000000000000000000000000000010110
0000000000100010000110000000000000000000000000000000000000000000000000000000000000000010010001
0000000000010110000000000000111000000000000000000000000000000000000000000000000000000000000111
0000000000001110000000000000000000000000000000000000000000000000000000000000000000111000000010
0000000000011110000000000000000000000000000000000000000000000000000000000000000001101110001000
0000000000000010000000000000000000000000000000000000000000000000000000000000000000000000011100
0000000000000000001100111001000000100000000110000101000010000000000000010000000000000000011000
0000000000100000000000100000000011001001000000001100000000000000001000110000000100000000000111
0000000000000000001000000000110101000011101110110001110111001110111001110001000100011110011111
0000000000010110000110110101010100100111001010110011110100110011000101110001000000011110011111
0000000000100000000000000000000000000000000000000000000000000000000000000001000000000000000000
0000000000000000000000000000000000000000000000000000000000000000000000000001000100000000011110
0000000000000010000000000000000000000000000000000000000000000000000000000001100100000000011100
0000000000100110001000011100101000000101110010001111110100010000001000111001000000001110011000
0000000000100000000010000010001011111000100110100001000100011001011111100100000001110010011001
0000000000011110000000000000000000000000000000000000000100000100000000000000000000000000011010
0000000000111110001100000000000000000000000000000000000100011100000000000000000000000100011000
0000000000001110000000000000000010000100110000000000000100000000000000000000000000000010011010
0000000000000110001100000000000000000000000000000000001000000000000000000000000000000110011111
0000000000000100001000000000001000000000000000000000000000001000000000000000000000001100000000
0000000000000000001100000000000000000000000000000000000100011000000000000000000000001100011111
0000000000001110000100000000000000100001000000000000000000010100000000000000000000000100000111
0000000000001110001000000000001000000001000100000100000000000000000000000000000000000100011001
0000000000110000001000000000001000011101000000000000001000000000000000000000000000000110011100
0000000000111000000000000000000000001100000100000100000000010001000000000000000000000010010000
0000000000110100001000000000011000000110000000000000000100000000000000000000000000000110000000
0000000000000110001000000000001000011100000000000000000100011000000000000000000000000100001001
0000000000111010001000000000001000001000000000000000000000000000000000000000000000000000011111
0000000000011100000000000000011000101001000000000000000000000000000000000000000000000000011101
0000000000011100000000000000000000101001000100000000000000000000000000000000000000000010011011
0000000000100000001000000000000000100101000100000000000000000000000000000000000000000000011011
0000000000000100000101100010111000100101000101100000000100000000000111000111110001111010010111
0000000000001110001011010011100000100100000011111100111100010010111001111001111111001100011111
0000000000001100000000000000000000000000000000000000000000000000000000000000001000000000000000
0000000000100110000000000000000000000000000000000000000000000000000000000000000000000000011010
0000000000001110000000000000000000000000000000000000000000000000000000000000000000000000011111
0000000000100000000011000110001111001100000110000111000001100110000000110101111111011111011111
0000000000110100001110111101111110001100111000000000000011010010000101101111111111111110010100
0000000000110100111100111111111000000000000111010001001111101100011011101111111101111110000011
0000000000110111110010011001111000011111111111100000111100010010111111011111111011111100001111
0000000000000000000000000000000000000000000000000000000000000000000000000000000000000000000000
0000000000000000000000000000000000000000000000000000000000000000000000000000000000000000000000
0000000000000000000000000000000000000000000000000000000000000000000000000000000000000000000000
0000000000000000000000000000000000000000000000000000000000000000000000000000000000000000000000
0000000000000000000000000000000000000000000000000000000000000000000000000000000000000000000000
0000000000000000000000000000000000000000000000000000000000000000000000000000000000000000000000
0000000000000000000000000000000000000000000000000000000000000000000000000000000000000000000000
0000000000000000000000000000000000000000000000000000000000000000000000000000000000000000000000
0000000000000000000000000000000000000000000000000000000000000000000000000000000000000000000000
