0
93
-60
20
0000000000111111111111111111111111111111111111111111111111111111111111111111111111111111111111
0000000000100000000001110111111111111001111111111100001000000001111000111010000011001100000101
0000000000111100111011111111100110001111111100000000011110000001111001111011001110000000100001
0000000000111010000011111110011001110100000000010000000000011111101111111010111110001111111111
0000000000101101111111111111111111111111111111111111111111111111111111111111111111111111111101
0000000000111111111111111111111111111111111111111111111111111111111111111111111111111111110001
0000000000111111111111111111111111111111111111111111111111111111111111111111111111111111111111
0000000000100001110000000000000000000000000000000000000000000000000000000000000000000001110001
0000000000100011110000000000011110000000000000000000001000000000000001100000000000000001111111
0000000000100001111000000000000000000000000000000000000000000000000000000001000000000001111111
0000000000111101111000000000000000000000000000000000000000000000000000000000000000000001111111
0000000000111101110000000000000000000000000000000000000000000000000000000000000000000001111101
0000000000101111110000000000000000000000000000000000000000000000000000000000000000000001111111
0000000000111101110000000000000000000000000000000000000000000000000000000000000000000011111101
0000000000111111110000000000000000000000000000000000000000000000000000000000000000000011110001
0000000000111101110000000000000000000000000000000000000000000000000000000000000000000001110001
0000000000111111110000000000000000000000000000000000000000000000000000000000000000000001110001
0000000000101111110000000000000000000000000000000000000000000000000000000000000000000001110111
0000000000111111110000000000000000000000000000000000000000000000000000000000000000000001110101
0000000000100001111000000000000000000000000000000000000000000000000000000000000000000001110001
0000000000111111110000000000000000000000000000000000000000000000000000000000000000000001110111
0000000000111111110000000000000000000000000000000000000000000000000000000000000000000001111111
0000000000100101111000000000000000000000000000000000000000000000000000000000000000000001111101
0000000000100011110000000000000000000000000000000000000000000000000000000000000000000101111101
0000000000101111110100000000000000000000000000000000000000000000000000000000000000000001110001
0000000000110101110000000000000000000000000000000000000000000000000000000000000000000001110011
0000000000100001110100000000000000000000000000000000000000000000000000000000000000000001111001
0000000000110011111100000000000000000000000000000000000000000000000000000000000000000001110111
0000000000100111111000000000000000000000000000000000000000000000000000000000000000000001111011
0000000000101111110000000000000000000000000000000000000000000000000000000000000000000101111111
0000000000110011110000000000000000000000000000000000000000000000000000000000000000000011110001
0000000000100001110000000000000000000000000000000000000000000000000000000000000000000001111111
0000000000100011110100000000000000000000000000000000000000000000000000000000000000000001110111
0000000000100011110110000000000000000000000000000000000000000000000000000000000000000011110001
0000000000110111110000000000111000000000000000000000000000000000000000000000000000000001110111
0000000000101111111111111111111111111111111111111111111111111111111111111110000000111001110011
0000000000111111111111111111111111111111111111111111111111111111111111111110000001101111111001
0000000000100011111111111111111111111111111111111111111111111111111111111110000011111111111101
0000000000100001111100111001000000100000000110000101000010000000000000011110000011111111111001
0000000000100001110000100000000011001001000000001100000000000000001000111110000111111111110111
0000000000100001111000000000110101000011101110110001110111001110111001111111000111111111111111
0000000000110111110110110101010100100111001010110011110100110011000101111111000011111111111111
0000000000100001111111111111111111111111111111111111111111111111111111111111000011111111110001
0000000000100001111111111111111111111111111111111111111111111111111111111111000111111111111111
0000000000100011111111111111111111111111111111111111111111111111111111111111100111111111111101
0000000000100111111000011100101000000101110010001111110111110000001000111001000000001111111001
0000000000100001110010000010001011111000100110100001000111111001011111100100000001110011111001
0000000000111111110000000000000000000000000000000000000111100100000000000000000000000001111011
0000000000111111111100000000000000000000000000000000000111111100000000000000000000000101111001
0000000000101111110000000000000010000100110000000000000111100000000000000000000000000011111011
0000000000100111111100000000000111111111111000000000001011100000000000000000000000000111111111
0000000000100101111000000000001111111111111000000000000011101000000000000000000000001101110001
0000000000100001111100000000000111111111111000000000000111111000000000000000000000001101111111
0000000000101111110100000000000111100001111000000000000011110100000000000000000000000101110111
0000000000101111111000000000001111000001111100000100000011100000000000000000000000000101111001
0000000000110001111000000000001111011101111000000000001011100000000000000000000000000111111101
0000000000111001110000000000000111001100111100000100000011110001000000000000000000000011110001
0000000000110101111000000000011111000110111000000000000111100000000000000000000000000111110001
0000000000100111111000000000001111011100111000000000000111111000000000000000000000000101111001
0000000000111011111000000000001111001000111000000000000011110000000000000000000000000001111111
0000000000111101110000000000011111101001111000000000000011110000000000000000000000000001111101
0000000000111101110000000000000111101001111100000000000000000000000000000000000000000011111011
0000000000100001111000000000000111100101111100000000000011110000000000000000000000000001111011
0000000000100101110101100010111111100101111101100000000111110000000111000111110001111011110111
0000000000101111111011010011100111100100111011111100111111110010111001111001111111001101111111
0000000000101101111111111111111111111111111111111111111111111111111111111111111111111111110001
0000000000100111111111111111111111111111111111111111111111111111111111111111111111111111111011
0000000000101111111111111111111111111111111111111111111111111111111111111111111111111111111111
0000000000100000000011000110001111001100000110000111000001100110000000110101111111011111011111
0000000000110100001110111101111110001100111000000000000011010010000101101111111111111110010101
0000000000110100111100111111111000000000000111010001001111101100011011101111111101111110000011
0000000000111111111111111111111111111111111111111111111111111111111111111111111111111111111111
0000000000000000000000000000000000000000000000000000000000000000000000000000000000000000000000
0000000000000000000000000000000000000000000000000000000000000000000000000000000000000000000000
0000000000000000000000000000000000000000000000000000000000000000000000000000000000000000000000
0000000000000000000000000000000000000000000000000000000000000000000000000000000000000000000000
0000000000000000000000000000000000000000000000000000000000000000000000000000000000000000000000
0000000000000000000000000000000000000000000000000000000000000000000000000000000000000000000000
0000000000000000000000000000000000000000000000000000000000000000000000000000000000000000000000
0000000000000000000000000000000000000000000000000000000000000000000000000000000000000000000000
0000000000000000000000000000000000000000000000000000000000000000000000000000000000000000000000
